I - Я
speak - говорить (как-либо; или на каком-то языке)
English - англйский (язык)
can - могу, умею (мод. гл.)
understand - понимать
you - ты, тебе
it - это; оно
very - очень
well - хорошо
work (on) - работа, работать (над)
study - учиться
and - и
learn (from) - изучать; заниматься (учёбой)
like - нравиться; как, подобно (чему-либо, кому-либо)
this - этот
online - онлайн
place - место; размещать (заказ)
city - город (мегаполис)
town - город (маленький)
live (in|at) - жить (в)
in - в
Russia - Россия
New York - Нью-Йорк
country - страна; деревня
we - мы
they - они
help - помощь, помогать
me - меня, мне
really - действительно, реально; очень
want - хотеть
lesson - урок
video - видео
program - программа
see - видеть
my - мой
result - результат
Russian - русский (язык)
know - знать
go (to|on) - идти, ходить (в,к|на); ехать
to - в; к; чтобы
school - школа
often - часто
here - здесь; сюда
there - там; туда
language - язык (речь)
every - каждый
day - день; сутки
travel (around) - путешествовать
year - год
travelling - путешествие
game - игра
play - играть
football - футбол
so - так, такой; поэтому
also - также; тоже
think (... over) - (об)думать
about - о, об
sometimes - иногда
love - любить, любовь
song - песня
music - музыка
read - читать
book - книга; бронировать
more - больше
much - много (для неисчисляемых; в отрицании или вопросе); сильно
less - меньше
practice, practise - практиковать; практика
these - эти
those - те
usually - обычно
buy - купить, покупать
thing - вещь; дело
