absolutely - абсолютно, полностью
agree - соглашаться, быть согласным
better - лучше; более хороший
cost - стоить (о цене)
dollar - доллар
euro - евро
far - далеко
feel - чувствовать себя
fifty - пятьдесят
he - он
less - меньше
do - делать (воспроизводить)
make - делать (заново)
mistake - ошибка
near - рядом, около
pound - фунт стерлингов
problem - проблема
she - она
ten - десять
that - тот; что (указат.)
ticket - билет
together - вместе
twenty - двадцать
with - с
call - звонить; звонок, вызов
happen - случаться, происходить
hear - слышать
how - как
idea - идея
little - мало
a lot (of) - много (в утверждении)
lots (of) - много
on - на
people - люди
person - человек
say - говорить (вообще)
tell - сказать, рассказывать, говорить, разговаривать (кому-либо)
too - тоже, также; слишком
TV, television - телевизор; телевидение
us - нам, нас
watch - смотреть
why - почему, зачем
