be - быть
become - становиться
businessman - бизнесмен
correctly - правильно; корректно
designer - дизайнер
doctor - доктор; врач
fluently - свободно; бегло
happy - счастливый
her - ей; её
him - его (самого); ему (самому)
manager - менеджер
new - новый
now - сейчас
programmer - программист
them - их (самих); им (самим)
visit - посещать; визит
without - без
would - (было, если) бы (мод. гл.)
abroad - за границей
China - Китай
England - Англия
father - отец
Germany - Германия
his - его (что-либо)
Italy - Италия
Japan - Япония
month - месяц
mother - мать
next - следующий; дальше
the United States (of America), the USA - Соединённые Штаты (Америки), США
the United Kingdom, the UK - Соединённое Королевство
their - их (что-либо)
week - неделя
