accountant - бухгалтер
bedroom - спальня
bright - яркий
chess - шахматы
college - колледж
comment - комментарий
disappointed - разочарованный
diving - дайвинг
draw - рисовать
drawing - рисование
episode - эпизод
expression - выражение
fifteen - пятнадцать
gardening - садоводство
genius - гений
heavy - тяжёлый
hobby - хобби
humour - юмор
its - его, её (для неодушевлённых предметов)
jacket - куртка
lamp - лампа
learning - изучение
lecture - лекция
main - главный, основной
nurse - медсестра
prison - тюрьма
resource - ресурс
sense - чувство (рецепторное)
shocked - шокированный
skiing - катание на лыжах
suit - костюм; подходить (по положению)
surprised - удивлённый
taste - вкус (сущ., гл.)
thief (thieves) - вор (воры)
towel - полотенце
