be - was / were - been : быть
become - became - become : становиться
begin - began - begun : начинать(ся)
blow - blew - blown : (по)дуть
break - broke - broken : ломать
bring - brought - brought : приносить
build - built - built : строить
buy - bought - bought : купить, покупать
can - could - * : мочь; уметь
catch - caught - caught : ловить, поймать
choose - chose - chosen : выбирать
come - came - come : приходить
cost - cost - cost : стоить (о цене)
cut - cut - cut : резать
do - did - done : делать (дела)
drive - drove - driven : водить (авто)
drink - drank - drunk : пить
eat - ate - eaten : есть, кушать
fall - fell - fallen : падать, упасть
feel - felt - felt : чувствовать (себя)
find - found - found : находить
fly - flew - flown : летать
forget - forgot - forgotten : забывать (о чём-либо)
get - got - got : получать, получить
get up - got up - got up : вставать (проснувшись)
give - gave - given : давать, дать
go - went - gone : идти, ходить; ехать
grow (up) - grew (up) - grown (up) : (вы)расти
have - had - had : иметь
hang - hung - hung : вешать, висеть
hear - heard - heard : слышать
hide - hid -hid : прятать
hit - hit -hit : ударить (рукой)
keep - kept - kept : хранить, сохранять; держать, сдерживать
know - knew - known : знать
lead - led -led : приводить, привести; лидировать
learn - learnt - learnt : изучать
leave - left - left : уезжать, покидать; забывать, оставлять (что-либо где-либо)
lose - lost - lost : терять; проигрывать
make - made - made : делать (ошибки)
mean - meant - meant : означать; иметь ввиду
meet - met - met : встречать, встретить
overcome - overcame - overcome : преодолевать, преодолеть
pay - paid - paid : платить (за что-либо, кого-либо)
put - put - put : ложить, положить; класть
read - read - read : читать
ride - rode - ridden : ездить, кататься (на велосипеде, на лошади)
run - ran - run : бежать
say - said - said : говорить, сказать
see - saw - seen : видеть
sell - sold - sold : продавать
send - sent - sent : отправлять, посылать
show - showed - shown : показывать
sing - sang - sung : петь
sit (down) - sat (down) - sat (down) : сидеть; садиться
sleep - slept - slept : спать
spend - spent - spent : тратить (деньги); проводить (время)
speak - spoke - spoken : говорить (как-либо; или на каком-то языке)
stand (up)  - stood (up) - stood (up) : стоять; вставать
steal - stole - stolen : красть, воровать
swim - swam - swum : плавать
take - took - taken : брать, взять; принимать
teach - taught - taught : преподавать, обучать
tell - told - told : сказать, рассказать, рассказывать (кому-либо)
think - thought - thought : думать
understand - understood - understood : понимать
wake up - woke up - woken up : просыпаться
withdraw - withdrew - withdrawn : снимать (деньги со счёта)
win - won - won : выигрывать; побеждать
write - wrote - written : писАть
